  XXXXX
XXX...X
XGMJ..X
XXX.JGX
XGXXJ.X
X.X.G.XX
XJ.jJJGX
X...G..X
XXXXXXXX
