XXXXXXXXXXX
X..GX..XM.X
X......XJ.XX
X..GX..X...X
X..XXJJ.J..X
XG.GX......X
XXXXXXXXXXXX
