XXXXXXX
X.....X
X.....X
XGX...X
XXXX.XX
X.J...X
X.....X
X..XXXX
X....MX
X.....X
X...XXX
XXXXX
