  XXXXX
XXX...X
XGMJ..X
XXX.JGX
XGXXJ.X
X.X.G.XX
XJ.JJJGX
X...G..X
XXXXXXXX
