XXXXXXX
X.....X
X.J...X
XGXG..X
XXXX.XX
X.....X
X.J...X
X..XXXX
X....MX
X.....X
X...XXX
XXXXX
