XXXXXXXXXXXX
XX...X.....X
XX...X.....X
XX.JJ.XGGXXX
X......MXXXX
X...X...XXXX
XXXXXXXXXXXX
