XXXXXXXXXXXX
XX...X.....X
XX...X.....X
XX..J.XG.XXX
X......MXXXX
X...X...XXXX
XXXXXXXXXXXX
