XXXXXXXXXXXX
XX...X.....X
XX...X..G..X
XXJJJ.XGGXXX
X......MXXXX
X...X...XXXX
XXXXXXXXXXXX
