XXXXXXX
X.....X
X.J..JX
XGXG.GX
XXXX.XX
X.....X
X.....X
X..XXXX
X....MX
X.J...X
X...XXX
XXXXX
