#####
#...##
#....#
#....##
#.....#
#...#.#
#...#.#
##....#
###...#
#.....#
#.....#
#######
