  #####
###   #
#+@o  #
### o+#
#+##o #
# #   ##
#o ooo+#
#   +  #
########
